Rotile - wheel - daca set - Alloy Wheels & Tyres Set , daca una Alloy Wheel & Tyre Single
Becuri din fara - Headlight Bulb Cover
fly wheel and clutch(ambreiajul) - Clutch & Dual Mass Flywheel Dmf
corobca - gearbox - Gearbox
engine - daca ii complect - Complete Engine , daca ii gol Engine Diesel Bare pentru diesel + engine petrol bare daca ii petrol
scaune - seats - Set Of Seats 
roata de rezerva - spare wheel - daca ii numa roata Space Saver Spare Wheel daca are si tools(instrumente) Spare Wheel & Jack Kit
asela din bagajnic - parcel shelf - Parcel Shelf
airbagul din pod - curtain sau roof airbag - Air Bag Curtain Side Left Side 
door card - Door Card Left Side Front
padcrilnic - arch liner - Inner Wing Arch Liner Front Left Side daca ii intreg sau Arch Liner Front Left Side Front Half daca ii jumatate
pomba din bac - fuel pump - Fuel Pump In Tank
oglinda de pe usa - mirror - Wing Door Mirror Left Side 
gabarit din bamper - fog light - Fog Light Front Left Side
bamperul - bumper - Bumper Front daca ii complect - Bumper Bare Front daca ii gol
usa - door - Door Bare Front Left Side
capota - bonnet - Bonnet
bagajnic - tailgate sau bootlid - Tailgate sau bootlid
aripa - wing - Wing Right Side
tarpeda - dashboard - Complete Dashboard
telivizor - slam panel - Slam Panel
balca - subframe - Subframe Front
parogul - side skirt - Side Skirt Left Side
complect de radiatore - rad pack - Radiator Rad Pack
   doar ventilatorul de pe radiator - radator fan - Radiator Fan Cowling
   doar radiatorul de la tasol - coolant radiator - Coolant Radiator
   doar radiatorul de la conditioner - aircon rad - Air Con Radiator
   doar radiatorul de aer - inrcooler - Intercooler
usiliteli - crash bar - Crash Bar 
granata - driveshaft - Drive Shaft Left Front  lunga sofer - scurt pasager
suport la radiator - Radiator Support Panel 
reactivnaia teaga - anti roll bar - Anti Roll Bar Front
airbagul de la capota - Pedestrian Air Bag uneori sunt right si pasanger
stupia - hub - Hub Wheel Bearing Left Side Front 
riciag din spate - wishbone - Lower Arm Wishbone Front Right Side 
motor de la stergatoare - wiper motor - Wiper Motor Front
riciag de la reica - tie rod , track - Track Rod End Left Side
reica - steering rack - Steering Rack
amortizator - shock apsorber - Shock Absorber & Spring Left Side Front pentru front Rear Shock Right pentru spate
suport - caliper - Caliper Carrier Rear Right
consola - Centre Console
capacul de pe motor - Engine Cover - Engine Cover
criplenie la bamper - bumper brack - Rear Bumper Bracket Left pentru spate , Wing Support Bracket Left Side pentru fata
bacioc de la tasol - coolant tank - Coolant Expansion Fluid Reservoir Tube
vacumu de la tormoz - bracke servo - Brake Master Cylinder & Servo
bacioc de la amivaic - washer bottle - Washer Bottle & Motor
filtru de aer la motor - air filter box - Air Filter Box
balamari de la capot - bonnet hinge - Bonnet Hinge Left Side
starter - starter - Starter Motor
sensorul de inaltime - level sensor - Headlight Level Sensor Rear Left Side
baterie mica - auxilliary battery - Auxiliary Battery
bardacioc - glove box - Glove Box
airbagul de sofer picioare - driver airbag - Air Bag Knee
grila de pe mijloc de la aer contitionat- centre air vent - Centre Dash Vents & Surround
plastcu de mijloc la tarpeda - Centre Dash Trim - Centre Dash Trim
cura de la siguranta - seat belt - Seat Belt Right Front
airbag de pe volan - steerimg wheel airbag - Steering Wheel Air Bag
rucica de la pavaroate + blijnii dalnii - indicator stalk - Indicator Stalk
volanul - Steering Wheel - Steering Wheel
ecranul - display - Sat Nav Display Screen daca are gps sau Multi Function Screen daca ii  simplu
butonul de la gabarite - light switch - Light Control Module
blocu de la xenon - xenon module - Headlight Control Unit ECU
blocu de la navigare - head unit - Head Unit
blocu de la aibag - arbag ecu - Air Bag Module
climat control - climat control - Digital Control Panel
reliusca start stop - start stop relay Relay/Fuse Box Cover
blocu de la pompa din bac - fuel pump control module - Fuel Pump ECU Module
blocu de la parctronici - parking ecu - Parking Aid Unit
blocu de la pietoni - pedistrian module - Pedestrian Protection ECU Module
blocu de la slipie zoni - 
fara din fata - headlight - Headlight Headlamp Left Side
fara din spate - rear light - Rear Tail Light Left Side Outer 
ECU KIT- ECU SAU Speedo clocks & ECU
SAT NAV & MULTIMEDIA MODULE---Sat Nav Data SD Card
 RADIO CONTROL SWITCH PANEL--- Car Radio Control










 